No solution
No solution
1 2 2 4 3 1 4 3 
1 2 2 4 3 1 4 3 5 5 
1 1 2 5 3 8 4 6 5 3 6 7 7 2 8 4 
1 5 2 3 3 8 4 4 5 7 6 1 7 6 8 2 
No solution
No solution
No solution
No solution
No solution
1 3 2 5 3 8 4 4 5 1 6 7 7 2 8 6 
1 2 2 5 3 7 4 4 5 1 6 8 7 6 8 3 
1 2 2 8 3 10 4 4 5 9 6 3 7 5 8 7 9 11 10 1 11 6 
1 1 2 3 3 6 4 2 5 9 6 12 7 14 8 7 9 4 10 15 11 13 12 5 13 10 14 8 15 11 
1 3 2 1 3 6 4 4 5 2 6 7 7 5 
1 4 2 6 3 8 4 3 5 1 6 7 7 5 8 2 9 9 
No solution
No solution
No solution
1 1 2 10 3 8 4 2 5 4 6 7 7 13 8 11 9 5 10 12 11 6 12 9 13 3 
1 1 2 11 3 6 4 3 5 9 6 4 7 8 8 10 9 2 10 7 11 5 
